R 1920 1080
NO ./path
SO ./path
WE ./path
EA ./path

S ./path
F 220, 100, 0
C 225, 30, 0

        1111111111111111111111111111111
		1003320000000001100000000000001
		1011000000000011100000000000001
		1001000002000000000000300200001
111111111011000000000011100000000000001
110000000011030000000011100111111111111
100000000011000000000011100000010000001
111101111111111111000111100001111111111
11110000000000011000000001100000001
11000002000000000000110000000000011
10000000000000100000000000000000001
100003000000011100000000000000000001
110000300000011000000010101111000001
111101111111111111100000000000000001
1111000000000000000011000000000000011
1110000300000000000000000000NO111111
110000000000002000000000000000000001
1330000000000000000000000000000000011
1111111111111111111111111111111111111
