R 800 600
NO ./texture/eagle.xpm
SO ./texture/eagle.xpm
WE ./texture/eagle.xpm
EA ./texture/eagle.xpm

S ./texture/eagle.xpm
F 220,100,0
C 225,30,0

1111111111111111111111111111111
1002220000000001100000000000001
1011000000000011100000000000001
100100000200000000000020020000111111111
111111111011000000000011100000000000001
110000000011022000000011100111111111111
100000000011000000000011100000010000001
111101111111111111000111100001111111111
11110000000000011000000001100000001
11000002000000000000110000000000011
100000000000001000000000000000000011
100002000000011100000000000000000001
110000200000011000000010101111000001
111101111111111111100000000000000001
1111000000000000000011000000000000011
1110000200000000000000000000N11111111
110000000000002000000000000000000001
1220000000000000000000000000000000011
1111111111111111111111111111111111111
